##########
##########
##@     ##
##      ##
##  #$  ##
##  #   ##
##  #   ##
##     .##
##########
##########

##########
##########
##      ##
##@     ##
##  #$  ##
##  #   ##
##  #   ##
##     .##
##########
##########

##########
##########
##      ##
## @    ##
##  #$  ##
##  #   ##
##  #   ##
##     .##
##########
##########

##########
##########
##      ##
##  @   ##
##  #$  ##
##  #   ##
##  #   ##
##     .##
##########
##########

##########
##########
##      ##
##   @  ##
##  #$  ##
##  #   ##
##  #   ##
##     .##
##########
##########

##########
##########
##      ##
##      ##
##  #@  ##
##  #$  ##
##  #   ##
##     .##
##########
##########

##########
##########
##      ##
##      ##
##  #   ##
##  #@  ##
##  #$  ##
##     .##
##########
##########

##########
##########
##      ##
##      ##
##  #   ##
##  #   ##
##  #@  ##
##   $ .##
##########
##########

##########
##########
##      ##
##      ##
##  #   ##
##  #@  ##
##  #   ##
##   $ .##
##########
##########

##########
##########
##      ##
##      ##
##  #@  ##
##  #   ##
##  #   ##
##   $ .##
##########
##########

##########
##########
##      ##
##   @  ##
##  #   ##
##  #   ##
##  #   ##
##   $ .##
##########
##########

##########
##########
##      ##
##  @   ##
##  #   ##
##  #   ##
##  #   ##
##   $ .##
##########
##########

##########
##########
##      ##
## @    ##
##  #   ##
##  #   ##
##  #   ##
##   $ .##
##########
##########

##########
##########
##      ##
##@     ##
##  #   ##
##  #   ##
##  #   ##
##   $ .##
##########
##########

##########
##########
##      ##
##      ##
##@ #   ##
##  #   ##
##  #   ##
##   $ .##
##########
##########

##########
##########
##      ##
##      ##
##  #   ##
##@ #   ##
##  #   ##
##   $ .##
##########
##########

##########
##########
##      ##
##      ##
##  #   ##
##  #   ##
##@ #   ##
##   $ .##
##########
##########

##########
##########
##      ##
##      ##
##  #   ##
##  #   ##
##  #   ##
##@  $ .##
##########
##########

##########
##########
##      ##
##      ##
##  #   ##
##  #   ##
##  #   ##
## @ $ .##
##########
##########

##########
##########
##      ##
##      ##
##  #   ##
##  #   ##
##  #   ##
##  @$ .##
##########
##########

##########
##########
##      ##
##      ##
##  #   ##
##  #   ##
##  #   ##
##   @$.##
##########
##########

##########
##########
##      ##
##      ##
##  #   ##
##  #   ##
##  #   ##
##    @*##
##########
##########

