##########
##########
##   #  ##
## #    ##
## #$#  ##
##   #  ##
## #    ##
##@    .##
##########
##########

##########
##########
##   #  ##
## #    ##
## #$#  ##
##   #  ##
## #    ##
## @   .##
##########
##########

##########
##########
##   #  ##
## #    ##
## #$#  ##
##   #  ##
## #    ##
##  @  .##
##########
##########

##########
##########
##   #  ##
## #    ##
## #$#  ##
##   #  ##
## #    ##
##   @ .##
##########
##########

##########
##########
##   #  ##
## #    ##
## #$#  ##
##   #  ##
## #    ##
##    @.##
##########
##########

##########
##########
##   #  ##
## #    ##
## #$#  ##
##   #  ##
## #  @ ##
##     .##
##########
##########

##########
##########
##   #  ##
## #    ##
## #$#  ##
##   #@ ##
## #    ##
##     .##
##########
##########

##########
##########
##   #  ##
## #    ##
## #$#@ ##
##   #  ##
## #    ##
##     .##
##########
##########

##########
##########
##   #  ##
## #  @ ##
## #$#  ##
##   #  ##
## #    ##
##     .##
##########
##########

##########
##########
##   #  ##
## # @  ##
## #$#  ##
##   #  ##
## #    ##
##     .##
##########
##########

##########
##########
##   #  ##
## #@   ##
## #$#  ##
##   #  ##
## #    ##
##     .##
##########
##########

##########
##########
##   #  ##
## #    ##
## #@#  ##
##  $#  ##
## #    ##
##     .##
##########
##########

##########
##########
##   #  ##
## #    ##
## # #  ##
##  @#  ##
## #$   ##
##     .##
##########
##########

##########
##########
##   #  ##
## #    ##
## # #  ##
##   #  ##
## #@   ##
##  $  .##
##########
##########

##########
##########
##   #  ##
## #    ##
## # #  ##
##  @#  ##
## #    ##
##  $  .##
##########
##########

##########
##########
##   #  ##
## #    ##
## #@#  ##
##   #  ##
## #    ##
##  $  .##
##########
##########

##########
##########
##   #  ##
## #@   ##
## # #  ##
##   #  ##
## #    ##
##  $  .##
##########
##########

##########
##########
##  @#  ##
## #    ##
## # #  ##
##   #  ##
## #    ##
##  $  .##
##########
##########

##########
##########
## @ #  ##
## #    ##
## # #  ##
##   #  ##
## #    ##
##  $  .##
##########
##########

##########
##########
##@  #  ##
## #    ##
## # #  ##
##   #  ##
## #    ##
##  $  .##
##########
##########

##########
##########
##   #  ##
##@#    ##
## # #  ##
##   #  ##
## #    ##
##  $  .##
##########
##########

##########
##########
##   #  ##
## #    ##
##@# #  ##
##   #  ##
## #    ##
##  $  .##
##########
##########

##########
##########
##   #  ##
## #    ##
## # #  ##
##@  #  ##
## #    ##
##  $  .##
##########
##########

##########
##########
##   #  ##
## #    ##
## # #  ##
##   #  ##
##@#    ##
##  $  .##
##########
##########

##########
##########
##   #  ##
## #    ##
## # #  ##
##   #  ##
## #    ##
##@ $  .##
##########
##########

##########
##########
##   #  ##
## #    ##
## # #  ##
##   #  ##
## #    ##
## @$  .##
##########
##########

##########
##########
##   #  ##
## #    ##
## # #  ##
##   #  ##
## #    ##
##  @$ .##
##########
##########

##########
##########
##   #  ##
## #    ##
## # #  ##
##   #  ##
## #    ##
##   @$.##
##########
##########

##########
##########
##   #  ##
## #    ##
## # #  ##
##   #  ##
## #    ##
##    @*##
##########
##########

